001111111111111111111
000010000010000010001
101110111111101110111
100000100000101010101
111110101110101010101
101000101000100010101
101110111110101010101
100000101000001000101
101111101111101010101
100010100000001010101
101110101111101110101
100010000010000010101
101110111110111010101
101000001000100010001
101110101011111110111
100010101010001000101
101011101110111111101
101000000000000000101
101111101110101011101
101010101000101000001
111111111111111111101