11111111111111111111111111111111011111111111111111111111111111111111101111111111111111111111111111111111110111110111
11100111100000000011111111100000000001100000000011111111111111111111100000000000000000001111111111111111110000000111
11100000000000111111111110000000000111111111000000111111111111111111111000000000000111000000000000000000011100000111
00001111111100000011111110000000000000001111110000000000000000000000001111111111100000000000011111111111111100011111
10000000000000000000000000000000001111111111111111111000001111111111111111111111100001111111110000111111100001011111
11111111111000001111111111000000000001111111000000000000000000011111110000000000000110000000011111110101001111111111
11111111111011111111000000000001111111111111000000000000011111111011111111111111110111111101111101110101111111111111
11111111100011111111100000000011111100001111000000000000111111000011111111111111110000000000111001110000000000000000
11111110000000000000000000000000000001111111111110111111111111011111111111111111111111011111111001100111110000001111
00000001111111111111101111111111111111100000000000000000000000000000000111111111111111011111000000001111111111111111
11100000000000000000001111111111111111111111111111111000000000000000000000000111111111111111111111111111111000111111
11111100000011111111111111111111110111111111111111111001111111111101111111111111111111111111111111111111111110000111
11111111100000000011111111100000000000000000000011111100111111111100000000000000000000001111111111111111110000000111
11100000000000111111111110000000000111111111000000111110011111111111111000000000000111000000000000000000011100000111
00001111111111111111111110000000000000001111110000000000000000000000001110001111100000000000011111111111111100011111
10000000000001000000000000000000001111111111111111111000001111111111111111011111100001111111110000111111111111011111
11111111111000001111111111001111111111111111000000000000000000011111111111011111110110000000011111110101111111100000
11111111111011111111111111101111111111111111000000000000011111111011111111011111110110000001111100000101111111101111
11111111100011111111111111001111111100001111000000000000111111000011111111011111110000000000111111000000000000000000
11111110000000000000000000000000000001111111111110111111111111011111111111011111111111011111111111100111111111111111
00001111111101000000101111111111111111100000000000000000000000000000000111011111111111011111111111001111111111111111
11100000000000000000001111111111111111111111111111111000000000000000000000000111111111000000000000011111111111111111
11111001111110111111111111111111111111111100000000011111111110000011111111111111111111110001111111111111111000000011
11100011111000000000000000000000011111111110011111000001111111110111111111111111111111111000000000000000000001111111
00000111111111111111111111111110111111110000111111111100111111110000000000000000000000000000011111111111111111101111
10000000000000000000000000000000000000000000000000000000000000000000111111111111111100011111111111111111100000001111
11111111110000000000000000000000000000001111111110000000000000000000000000000000000000000000001111111000001111111111
11111111111111000000001111011111101110101111111111111011101010101011111111111111111111110101111111111111000001111111
11100000000000000111111110000000000000010111111111111111111110101010101111111111111111100000000000000000001111111111
10000000000000000000000000000000000000000000001111111111110000000000000000000000000000000000000000000000000000011111
11111111110000000000000000000000000000000000011111111111111111010101010101010101010111111100000011111111011111111111
00000000000000111111111111111111110111110000000000000000000000000000000000000000000000000000000000000000000011111111
11111111111111111111100000000011110111111111111111111111111111101011111111111111111111111101111111111111111111111111
11111111111111111111101111110011110000111111111110111111111111111111111111111111100000000000000000000000000111111000
11111111111111111111111111111000000111110001100000000000000000000000000000000000000000000000000000000000000000000101
00000000000000000000000111111110111111111000000100000111110000000111111111111111111111111111110000000000000000111101
11111111111111111111000000000001111111111111111111111100000000000011000000000000000000000000000000001111111110000001
11111111111111111111111110000000000000000000111111111111111111111000000000000000000000000000001111111111111111111111
11000000000000000000000000000000000000000000000000000001010101010111111111110000000000111111111111111111111111111111
11111111111111101111111111111111110000001111111111110001000111010111111111111100011111111111111111100000000000000001
11111111000000000000111110000000000000000001110000000000000000000000000000011111111111111111111111111111000000011111
11111100011111101111111111111111111111111111111111101111111111111111111111111111111111000000000000000000011111111111
00000000111111100111111111111111111111111111111111100001111111111111111111111111111111101111111100000000000000111111
11111101100000000011111111100000000000000000000011111100111111111100000000000000000000001111111111111111110000000111
11100000000000111111111110000000000111111111000000111110011111111111111000000000000111000000000000000000011100000111
10001111111111111111111110000000000000001111110000000000000000000000001111111111100000000000011111110111111100011111
10000000000000000000000000000000001111111111111111111000001111111111111111111111100001111111110000110111111111011111
11111111111000001110000001111111111111111111000000000000000000011111111000000011101100000000111111101011111111000011
11111111111011111111100011111111111111111111000000000000011111111011111111100111110111111101111111110101111111101111
11111111100011111111110111111111111100001111000000000000111111000011111111111111110000000000111111110000000000000000
11111110000000000000000000000000000001111111111010111111111111011111111111111111111111011111111111100111111111111111
11111111111101111111111111111111011111111111000011111111110000011111101111111111111111111111111111111000000111110000
11111111100000000011111111100000000000000000000011111111111111011111100000000000000000001111111111111101110000000111
11100000000000111111111110000000000111111111000000111111111111011111111000000000000111000000000000000000011100000111
00001111111111111111111110000000000000001111110000000000000000000000001111101111100000000000011111111111111100011111
10000000000000000001100000000000001111111111111111111000001111111111011111001111100001111111110000111111111111011111
11111111111000001101111011111111111111111111000000000000000000011111000000011111110110000000011111110101111111111111
11111111111011111100000001111111111111111111000000000000011111111011110011111111110111111101111111110101111111111111
11111111100011111111111111111111111100001111000000000000111111000011111000011111110000000000111111110000000000000000
11111110000000000000000000000000000001111111111110111111111111011111111111111111111111011111111111100111111111111111
00000001111111111111101111110110011111100000000000000000000000000000000111111111111111011111111111001111111111111111
11100000000000000000001111100011011111111111111111111000000000000000000000000111111111111111111111111111111000111111
11111100000011111111111000000011010111111111111111111001111111111101111111111111111111111111111111111111111110000111
11111111100000000011111111100000000000000000000011111100111111111100000000000000000000001111111111111111110000000111
11100000000000111111111110000000000111111111000000111110011111111111111000000000000111000000000000000000011100000111
10001111111111111111111110000000000000001111110000000000000000000000001111111111100000000000011111111111111100011111
10000000000000000000000000000000001111111111111111111000001111111111111111111111100001111111110000111111111111011111
11111111111000001111111111110001110011111111000000000000000000011111111111101101110110000000011111110101111111100000
11111111111011111111111111111100000111111111000000000000011111111011111111100000110111111101111111110101111111101111
11111111100011111111111111111111111100001111000000000000111111000011111111110111110000000000111111110000000000000000
11111110000000000000000000000000000001111111111110111111111111011111111110000000011111011111111111100111111111111111
00001111111101000000101111111111111111100000000000000000000000000000000111111111000111011111111111001111111111111111
11100000000000000000001111111111111111111111111111111000000000000000000000000111011111000000000000011111111111111111
11111111111110111111111111111111111111111110000000000001111110000011111111111111011111110001111111111111111000000011
11111111111000000000000000000000011111111111110000010011111111110111111111111111011111111000000000000000000001111111
10000111111111111111111111111110111111111111111110010011111111110000000000000000000000000000011111111100001111111111
10000000000000000000000000000000000000000000000000010000000000000000000000000000000000011111111111100000111111111111
11111111110000000000000000000000000000001111111110000000000000000000000000000000000000000000001111111100001111111111
11111111111111000000001111011111101110101111111111111011101010101011111111111111111111110101111111110000100000111111
11100000000000000111111110000000000000010111111111111111111110101010101111111111111111100000000001110001001111111111
10000000000000000000000000000000000000000000001111111111110000000000000000000000000000000000000000000000000000011111
11111111110000000000000000000000000000000000011111111111111111010101010101010101010111111100000011111111011111111111
00000000000000111111111111111111110111110000000000000000000000000000000000000000000000000000000000000000000011111111
11111111111111111111100000000011110111111110111101111110101111101011111111111111111111111101111110000111111111111111
11111111111111111111101111110011110000111110111100001110101111111111111111111111100000000000000000000000000111111000
11111111111111111111111111111000000111111100111101011110100000111111111111110000000011000000011111000000000000000101
00000000000000000000000111111110111111111110011100111110001111111111111111111111111111111111110000000000000000111101
11111111111111111111000000000001111111111111000000111111111111111111000000000000000000000000000000001111111110000001
11111111111111111111111110000000000000000000111111111111111111111000000000000000000000000000001111111111111111111111
11000000000000000000000000000000000000000000000000000001010101010111111111110000000000111111111111111111111111111111
11111111111111101111111111111111110000001111111111110001000111010111111111111100011111111111111111100000000000000001
11111111000000000000000000000000000000000000000000000000000000000000000000011111111111111111111111111111000000011111
11111100011111111111110000000000100000001111111111101111111111111111111111111111111111000000000000000000011111111111
00000000111111111111111111111100010001111111111111100001111111111111111111111111111111101111111100000000000000111111
11111101100000000011111111100000010000000000000011111100111111111100000000000000000000001111111111111111110000000111
11100000000000111111111110000011110111111111000000111110011111111111111000000000000111000000000000000000011100000111
00001111110111111111111110000000000000001111110000000000000000000000001111111111100000000000011111110101111100011111
10000000000000000000000000000000001111111111111111111000001111111111111111111111100001111111000000110101111111001111
11111111111000001111111111111111111111111111000000000000000000011111111111111111110110000000011111110101111111100000
11111111111011111111111111111111111111111111001111111111111111111011111111111111110111111101111111110101111111101111