1111111
1110111
1000111
1100001
1111011