0001111111111111111111111111111111111111111111111111111111111111111111111111111111111111111111111111111111111111111111111111111111111111111111111111111
0000000000000001000000001000000001000000000000000001001001000000000001000001000000000001000001000001000000001000000000000001000001001001000000001000001
1001100011001111001111111001001111001111001111001111001001000000001111001111001001111001001001001000000000000001111001111111001111001001111111001001111
1001000000001000000000001001000000001000001000000001000000001001000001000000001001000001001001001001000000000001001000001001000000001001000000001000001
1001001111001111001000000000111001110001111001001111001001111001001001111000011001111111001001001111001100000111001001001001111001111001111001001111001
1001000001001000000000000000001001000000000001001000001001000001001000000000000000001001001001000000000001000000000001000001000000001001000001000000001
1100000011001001001111011111001001111001001001001111001111001111111001001001001111001001111001111111001001001110001111001111111111001001111111001001001
1000001000001001000000000001001000001001001001000001000001000001000001001001001000000000001001000000001001000000001000001000001001001001000000001001001
1001111001001001111111111000001111111001111001111000001001001001001001001111111111001001111001111111001111000000000011001001111001001001111001001000011
1000001001001001000000000001000001001001000001001000000001001001001001001000001000001000001000001000000001000001000001001000001000001000001001000001001
1001111111000000000000000000000011001001111001001001111001001111001111111001001111111001111001111111001111111001001001001111001001111111001001111001001
1001001000000000001001000001000000001001000000000001000000000001000001000001000001001000001000000000000000001001001000001001000000000000001001001001001
1001001001001111111001001001001111100000001111111111001111001111001001001111111001001110000000111111001111111001111001111001111111111001111111001001001
1000001001000000001001001000001000001000000000001000001001001000001000001000000000000000001000001000001000000001001001000001000001001000001001000000001
1111001111001111111001111001111001111001111111001001001001111001111001111001111001111001111111001111111001001111001001111001111001001111001001001111111
1000000001000001000000001000000001001000001000001001000001000001001000001001000000001001001000001000001001000000001000000000001000000000000000000000001
1001001001001111111001001111001111001001111111001001001100001001001111111001001001001001001001001001001111001001001001001111001111100000001111001111001
1001001001000001000001000000000001000000000001000001000001001000001000000001001001001001000001001001001000001001001001001000001000000000000000000001001
1001111111001111111001111001111000000000000111111001111111001111001111111001001111001000000000000000000000000000000000000000000011001111001111001111001
1000000001000001000000001000000000001000000000000001000000001001001000001001000001001000000000001000000001001001000001001000000000001000001000001000001
1001111001000001111111111001001111111111001111111001001111111001111001001111111001111001111111001001111001001111001111001111001111111111001001001001111
1001000001001001001000001001000000001001000000001001001001001000001001001001000001000000001001000001000000001000000001001001001001001000001001001000001
1111001111001001001001111001110001111001001001111001001001001001111001111001111001111111001001111001001111111001111001001001001001001111001001111001001
1000001000000000000000001001000000001001001000001001001001000000000001000001000000000001001000001001000000001001001000001001000001001001001000001001001
1001001111000000000000001001111111001001001001111111001001111001001111111001111001001111001001111001111111111111001001111001001001001001111100000001111
1001001000000000001001000000000000001001001000001001000001000001001001000000001001001001001001000000000000001000001001000001001000001001000001000000001
1001111001111111001001001001111001001001001001111001111001001111001001111111001111111001111001111001111001111111001001001001001111001001001001001001111
1000001001000000001000001001001001001000001001000001001001000001000000000000000001001000001000000000001000000001000000001001000001001000001001001000001
1001111111001001001111111111001001001001111111011001001001111001111001001111001111001001111001001111111111001001111111001111001111111001111001001111001
1000000001001001001000000000000001001001000001000000000000001001001001000001000000001001000001000000001001001001001001000000000000001000001001001001001
1001001001111111001001111111001111111001111001111001111111111111001001001001111001111001001111111111001001001111001001111001111001001111001001111001001
1001001000001000001000001000001000000000001001000000000000000000000001001000001001000001001000000000000001001000001000000000001001001000001000000000001
1001111100000001111001111001111111001111001001111111001111111111001111111001001111001001111111001111001111111001111111111001001111001111001111111111001
1000000000000000001001000000001000000001000001001000001000001001000000001001000001001000000000000001001000000001000001000001000001000001001001000000001
1111001001111001111111001111111001001001111111001111111001111001110000000111111001111111111001111111001001111111111001001111111001001111001001111111001
1001001000001000000001000001000001001000000000001000001000001000001001000000000001000001000000000001000000001001000000000000001001000001000000001001001
1001001111001001111001111001111001111111111001111001001111001111001001001111111001001001001111111111001001001001111001001111111001111001001111001001001
1000000001001000001001001001001000000001001000000001000001001000000001000001000000001000001000001001001001001000000001001001000000001001001001000001001
1001111001111111100000000000000000000001001001111111001111001001001111001111111111001111001001001001001001111111111001111001111111001111001001001111111
1001001000001000001000001001000001001001001000001001000001000001001001001001001000001000001001000001001001000000000000001000001001000001000001001000001
1001001111111001001111001001001111001001001111001001111111111001111001001001001111001001111001001111001001001111001111001001111001111111111111001111001
1001000000000001000000000001001001001000001000001000001001000000001000001000000001001001001001001001001001000001000001000001000000000000001000000001001
1111111111001111001111001001001001001111001001111001111001001111111111001001111001001111001001001001001111111111111001001111111111001111111001111111001
1000000000000001000001001001000000001000001000001001000000000001000001001000001001000000001001001000000000001000001001000001001000000001000000000000001
1001000000000000011111111111001001111001111001111001111111001111111001001001100000110001111001111111001001111111001001111111001001001001111001001111001
1001000000001001000001000001001000001001000001000000000001000000001000001000000000001000000000000001001000001000001000000001000001001001001001001000001
1111111111001001001001001001111001111001111111001001111001000000000000000000000111100100111111100100100111100100100100111100100111111111100100111101001
1000000001000001001001001000000000000001001000001001000000001001000000001000001000001001000001001000001000001001001001000001000001000000001000001001001
1001111111001001111001001000000000111001001001001001111111111001001111001111111111001001001001001111111111001001001111001111111001001001111001111111001
1001000000001000000001001001000001001000000001001000000000001001000001000001000001000001001000000001000001000001000001001001000000001001000000001000001
1001111111001001111001001001001001001111111111111001111111111001001001111001001001111001111111111001111001001111111111111001111001001111001111001111111
1000000001001001001000001001001001000000001000000001000000000001001001000001001000000001000000001001001001000000001000000001001001000001000001001000001
1001111111111001001111001001001001111001001111001111111001111001111111111001111111001001111001111111001001111111001001001111001001111001001111111001001
1000000000001001000000001000001001000001001000000001001000001000000000001000001000001000000001001000000001000000001001001000000000001000000000001001001
1111001111111111111001111111001111001001111001001111001111111111111001001001111001111001001111001001001111111111001001111001001111111111111001111001001
1001000000001000001001000001001000001000001001000001000000000001001001001000000000001001000001000001001001001000000001000001000001000000000000001001001
1001111001111001111111001111111111111001111001001001111001111111001001001111001111111001111111111111001001001111001111111001111111001111001001111001111
1000001001000000000001000000000000001001001001001001001000000000000001001000001000001000000001000001000000000000000000001001000001001000001001001000001
1111001001001111111111111001110000111001001111111001001001100000001001001111001111001001111111111001111111111001001111001111111001111001001111001001111
1000001000000001000000001001000000000000000001000000001000001000000001001000000000001000000000001001000001000001001001000000000000001001000001001000001
1001001001001111001001111001001110000001111001001111000000001111110000000001001111001111111111001001111001111001111001111111001111001111001111001001111
1001000001001001001000001001000000000001000001000000001000001001001000000001001000001000000000001000000000001000001000001000001000000000000000000000001
1001001111111001111001001001111111001111001001111111001001001001001111111111001111111111111001001001111000000000111111001001111001001001001001001111001
1001000000000000000001000000000000001000001001000000000001000000000000000000000000001000001001001000001000001000001000000001000001001001001001001000001
1111001001111001111111111111001001111111111001001001111001100001001111001111111111111001111111111001001001111111001111111001111001001001001001000011001
1001001001000001000000000001001001000001001001001000001001001000001000000001000001000001000000000001001000001000001001000001001001001001001001001001001
1001001110000000001001111001111111111001001111111111111001001001001001111111001111001001001111001001111001001111001001001111001111111111001111001001111
1000000000000000001001000000000000000001000001000000001001000001001000000000001000001001000001001000000001001000001000000001000000000001001000000001001
1111001001111001111111001111001001100001111001111001111001001100000000011001001111111001111111001111111111111001111111001111001111111111111001001001001
1000001000001000001000000001001000001000000000001000001001000000000000001001000001000001000000001000000000001001000001001000001000000001000001001001001
1001001111111001100111001001111111001111001111001001111001111111001111001111111111001111001111111111001001111001001001001111001001001001001111001111001
1001001001000001000000001001000001001000000001001000001000000000000001000001000000001001000000000001001000001000001000001000001001001000000001000000001
1001111001001111111111111111111001111111111001111111001001111001111111000000000000000000000001001111001001111111111111001001001001111001001111111001001
1000001000000000001001001000001000000000001001000000000000001000000000000000001000001000000001000001001000001001001000001001000000001001001001001001001
1001111111001111001001001111001111111001111001111001111111001001001001111111111111001111001111111001111001111001001111001111001001111111111001001001111
1000001001001001001000001000001001001000000000001001000000001001001001000000000001001000000000001001001001000000001000001000001000000000001001000001001
1111111001001001111111001001111001001111001001111001001111001001111001111001111001001111001111001111001001001001001001001001111111001111001001111111001
1000000000000001000000001000001000000001001000001001000001001001001000001000001000001001000001001001000000001001000001001001000000000001001000000001001
1001111001001001111001001001111111111001111111001001111001111111001100000000111111001001001001111001001111111001111111001001001111001111001001111111001
1000001001001001000001000001000001001000000000001001001000001001000000001000000001000000001001000001001000000001001000000001000001001000000000000001001
1111001111111001001001001001001111001111001001111111001111001001111001001111111001111001111111001111111111001001001111001111111001111111111111001001001
1000000001000000001001001000000001001000001001000000000000001000000001000000001000001000001000000001001001001000000001001001001000001000001000001000001
1111111001111001111111001001111111001111001001001111111001100000001111001111001111001001111001001001001001001111111001111001001001111111001001111111001
1000001001000000001000001000001000000000001000000001001001000001000000000001001001000001001001001000000000000001000000001000000000001000001000001001001
1111001111001111001100011110000000110011001001111111001001001001001111111001111001111111001111111111001110011000011001111001111001111111001111111001111
1000001000001000001000000000001001000001001000001000000000001000000001000001000001000000000001000001001001000000000001001001000000000000000001001000001
1111001001111111111001111001111001001111111001111001111111001111000000011001111001111001001111111001001001001111001111001001111001001111111001001001001
1000001000001000000000001001001001000000001000001001000001000001000000000000000001000001000000000000001000001001000001001000001001001000000000000001001
1111001001100000111001111001001001001111111001111111001000000000111001001111001111000000000001001111111001111001111001001111111001111111111111001001111
1000001000001000001001000001000000000000000001001001001000000001000001001001000001000000000001000001000001000001000001000000000001001001000000001000001
1001111001111111001001001001111001111001111001001001111001111001111001001001111001001100001001111001111111111001001111001111111111001001111111001001001
1000001001000001000001001000000001001001000001000000000001000001000001000001001001000001001000001001000000000000000001000000000000000001000000001001001
1001111001111001001001001111001111001111001111111111001100000000111001111001001111111001001001111001111001001100000000001111111001111111111001111111001
1000001000000000001001001000000000001000001000001000000001001000000000001000000001000001000001000000001001001000001000001000000001000000000000001001001
1001001001111001111111111111001111001111001001111001111111001001111111111001111111111111001001111111001001001111001001111001111001001001111001111001111
1001000000001001000001000000000001001001001000000000001001000001001001001000001001000000001000001000001001001000001001001001001001001001000000001001001
1001111111001001111001001111111111111001001111111001111001111001001001001001111001111001001001111111001111111001111111001111001111001111001111111001001
1000001000001000000001000001000001001000001001000000000000000000001000000001001000000001001001000000000001000000000000000001000001001000001000001001001
1001111111001111111001111111001001001001111001001111001111001111111001111001001001111001001111001001111111111001001001111111001001111001001001001001001
1000001000000001000000000001001000000000001000001000001000001000000000001001000001000001001000001001000000000001001000000000001000000001000001000000001
1111111111111111111111111111111110111111111111111111111111111001110010111111111111111111111111111111111111111111111111111111111111111111111111111111001