1111111111111111
0011111000000001
1011111111110111
1000111110000001
1110111110110111
1110001110110111
1110000000000111
1111111111111111