11111111101111
00111100001111
10111101101111
10001101101111
10111100000011
10000001111111
11110111110011
11000111100111
11000001110111
11110111100011
11110000001111
11111111101111