0001111110111111111111000111111111111111011111111111111111111111111111111111101111100111111111111110111111111111111111111111111111111111111111111111111
0000000000000001000000001000000001000000000000000001001001000000000001000001000000000001000001000001000000001000000000000001000001001001000000001000001
1001111111001111001111111001001111001111001111001111001001111111001111001111001001111001001001001001001111111001111001111111001111001001111111001001111
1001000000001000000000001001000000001000001000000001000000001001000001000000001001000001001001001001000000000001001000001001000000001001000000001000001
1001001111001111001111111111111001111111111001001111001001111001001001111111111001000011001001001111001110001111001001001001111001111001111001001111001
1001000001001000000000000000001001000000000001001000001001000001001000000000000000001001001001000000000001000000000001000001000000001001000001000000001
1111111111001001001111101111001001111001001001001111001111001111111001001001001111001001111001111111001001001100110011001111111111001001111111001001001
1000001000001001000000000001001000001001001001000001000001000001000001001001001000000000001001000000001001000000001000001000001001001001000000001001001
1001111001001001111100000111001111111001111001110111111001001001001001001111001111001001111001111111001111111111111111001001111001001001111001001111111
1000001001001001000000000001000001001001000001001000000001001001001001001000001000001000001000001000000001000001000001001000001000001000001001000001001
1001111111001100000000000000000000000001111001001001111001001111001101111001001111111001111001111111001111111001001001001111001001111111001001111001000
1001001000000000001001000001000000001001000000000001000000000001000001000001000001001000001000000000000000001001001000001001000000000000001001001001001
1001001001001111111001001001001111100001111100000111001111001111001001001111111001001111111111111111001111111001111001111001111111111001111111001001001
1000001001000000001001001000001000001000000000001000001001001000001000001000000000000000001000001000001000000001001001000001000001001000001001000000001
1111001111001111111001111001111001111001111111001001001001111001111001111001111001111001101111001111111001001111001001111001111001001111001001001111111
1000000001000001000000001000000001001000001000001001000001000001001000001001000000001001001000001000001001000000001000000000001000000000000000000000001
1001001001001100111001001111001111001001111111001001001111111001001110111001001001001001001001001001001111001001001001001111001111111111111111001111001
1001001001000001000001000000000001000000000001000001000001001000001000000001001001001001000001001001001000001001001001001000001000000000000000000001001
1001111111001111111001111001110001111111100000001001111111001111001111111001001111001001001111001111001111001001001111001111111111001111001111001111001
1000000001000001000000001000000000001000000000000001000000001001001000001001000001001000000000001000000001001001000001001000000000001000001000001000001
1001111001001111111111111001001111111111001111011001001111111001111001001111111001111001111111001001111001001111001111001111001111111111001001001001111
0001000001001001001000001001000000001001000000001001001001001000001001001001000001000000001001000001000000001000000001001001001001001000001001001000001
1111001111001001001001111001111111111001001001111001001001001001111001111001111001111111001001111001001111111001111001001001001001001111001001111001001
1000001000000000000000001001000000001001001000001001001001000000000001000001000000000001001000001001000000001001001000001001000001001001001000001001001
1001001111001111111111001001111111001001001001110000001001111001001111111001111001001111001001111001111111111111001001111001001001001001111000001111111
1001001000000000001001000000000000001001001000001001000001000001001001000000001001001001001001000000000000001000001001000001001000001001000001000000001
1001111001111111001001001001111001001001001001111001111001001111001001001111001111111001111001111001111001111111001001001001001111001001001001001001111
1000001001000000001000001001001001001000001001000001001001000001000000000000000001001000001000000000001000000001000000001001000001001000001001001000001
1001111111001001001111111111001001001001111111111001001001111001111001001111001111001001111001001111111111001001111111001111001111111001111001001111001
1000000001001001001000000000000001001001000001000000000000001001001001000001000000001001000001000000001001001001001001000000000000001000001001001001001
1001001001111111001001111111001111111001111001111001111111111111001001001001111001111001001111111111001001001111001001111001111001001111001001111001001
1001001000001000001000001000001000000000001001000000000000000000000001001000001001000001001000000000000001001000001000000000001001001000001000000000001
1001110000001111111001111001111111001111001001111111001111111111001111111001001111001001111111001111001111111001111111111001001111001111001111111111001
1000000000000000001001000000001000000001000001001000001000001001000000001001000001001000000000000001001000000001000001000001000001000001001001000000001
1111001001111001111111001111111001001001111111001111111001111001110110000001111001111111111001111111001001111111111001001111111001001111001001111111001
0001001000001000000001000001000001001000000000001000001000001000001001000000000001000001000000000001000000001001000000000000001001000001000000001001001
1001001111001001111001111001111001111111111001111001001111001111001001001111111001001001001111111111001001001001111001001111111001111001001111001001001
1000000001001000001001001001001000000001001000000001000001001000000001000001000000001000001000001001001001001000000001001001000000001001001001000001001
1001111001111111111001001001001001111111001001111111001111001001001111001111111111001111001001001001001001111111111001111001111111001111001001001111111
1001001000001000001000001001000001001001001000001001000001000001001001001001001000001000001001000001001001000000000000001000001001000001000001001000001
1001001111111001001111001001001111001001001111001001111111111001111001001001001111001001111001001111001001001111001111001001111001111111111111001111001
1001000000000001000000000001001001001000001000001000001001000000001000001000000001001001001001001001001001000001000001000001000000000000001000000001001
1111111111001111001111001001001001001111001001111001111001001100000111001001111001001111001001001001001111111111111001001111111111001111111001111111001
1000000000000001000001001001000000001000001000001001000000000001000001001000001001000000001001001000000000001000001001000001001000000001000000000000001
1001001111111100000001111111001001111001111001111001111111001101111001001001111111000001111001111111001001111111001001111111001001001001111001001111001
1001000000001001000001000001001000001001000001000000000001000000001000001000000000001000000000000001001000001000001000000001000001001001001001001000000
1111111111001001001001001001111001111001111111001001111001001111111111111111001111001001111111001001001111001001001001111001001111111111001001111001001
1000000001000001001001001000000000000001001000001001000000001001000000001000001000001001000001001000001000001001001001000001000001000000001000001001001
1001111111001001111001001001111111111001001001001001111100111001001111001111111111001001001001001111111111001001001111001111111001001001111001111111001
1001000000001000000001001001000001001000000001001000000000001001000001000001000001000001001000000001000001000001000001001001000000001001000000001000001
1001111111001001111001001001001001001100000011111001111111111001001001111001001001111001100000011001111001001111111111111001111001001111001111001111111
1000000001001001001000001001001001000000001000000001000000000001001001000001001000000001000000001001001001000000001000000001001001000001000001001000001
1001111111111001001111001001001001111001001111001111111001111001111111111001111111001001111001111111001001111111001001001111001001111001001111111001001
1000000000001001000000001000001001000001001000000001001000001000000000001000001000001000000001001000000001000000001001001000000000001000000000001001001
1111001111111111111001111111001111001001111001001111001111110000111001001001111001111001001111001001001111111111001001111001001111111111111001111001001
1001000000001000001001000001001000001000001001000001000000000001001001001000000000001001000001000001001001001000000001000001000001000000000000001001001
1001111001111001111111001111111111111001111001001001111001100111001001001111001111111001111111111111001001001111001111111001111111001111001001111001111
1000001001000000000001000000000000001001001001001001001000000000000001001000001000001000000001000001000000000000000000001001000001001000001001001000001
1111001001001111111111111001111111111001001111111001001001111111111001001111001111001001111111111001111111111001001111001111111001111001001111001001111
1000001000000001000000001001000000000000000001000000001000001000000001001000000000001000000000001001000001000001001001000000000000001001000001001000001
1001001001001111001001111001001111111111111001001111111111001111111111111001001111001111111111001001111001111001111001111111001111001111001111001001111
1001000001001001001000001001000000000001000001000000001000001001001000000001001000001000000000001000000000001000001000001000001000000000000000000000001
1001001111111001111001001001111111001111001001111111001001001001001111111111001111111111111001001001111111111111111111001001111001001001001001001111001
1001000000000000000001000000000000001000001001000000000001000000000000000000000000001000001001001000001000001000001000000001000001001001001001001000001
1111001001111001111111111111001001111111111001001001111111111111001111001111110000001001111111111001001001111111001111111001111001001001001001111111001
1001001001000001000000000001001001000001001001001000001001001000001000000001000001000001000000000001001000001000001001000001001001001001001001001001001
1001001111111111001001111001111111111001001111111111111001001001001001000000000000000001001111001001111001001111001001001111001111111111001111001001111
1000000000000000001001000000000000000001000001000000001001000001001000000000001000001001000001001000000001001000001000000001000000000001001000000001001
1111001001111001111111001111001001111111111001111001111001001111111111111001001111111001111111001111111111111001111111001111001111111111111001001001001
1000001000001000001000000001001000001000000000001000001001000000000000001001000001000001000000001000000000001001000001001000001000000001000001001001001
1001001101111001110111001001111111001111001111001001111001111111001111001111111111001111001111111111001001111001001001001111001001001001001111001111000
1001001001000001000000001001000001001000000001001000001000000000000001000001000000001001000000000001001000001000001000001000001001001000000001000000001
1001111001001111111100000111111001111111111001111111001001111001111111111111001111001001111001001111001001111111111111001001001001111001001111111001001
1000001000000000001001001000001000000000001001000000000000001000000000000000001000001000000001000001001000001001001000001001000000001001001001001001001
1001111111001111001001001111001111111001111001111001111111001001001001111111111111001111001111111001111001111001001111001111001001111111111001001001111
1000001001001001001000001000001001001000000000001001000000001001001001000000000001001000000000001001001001000000001000001000001000000000001001000001001
1111111001001001111111001001111001001111001001111001001111001001111001111001111001001111001111001111001001001001001001001001111111001111001001111111001
1000000000000001000000001000001000000001001000001001000001001001001000001000001000001001000001001001000000001001000001001001000000000001001000000001001
0001111001001001111001001001111111111001111111001001111001111111001111000000000111001001001001111001001111111001111111001001001111001111001001111111001
1000001001001001000001000001000001001000000000001001001000001001000000001000000001000000001001000001001000000001001000000001000001001000000000000001001
1111001111111001001001001001001111001111001001111111001111001001111001001111111001111001111111001111111111001001001111001111111001111111111111001001001
1000000001000000001001001000000001001000001001000000000000001000000001000000001000001000001000000001001001001000000001001001001000001000001000001000001
1111111001111001111111001001111111001111001001001111111001111111111111001111001111001001111001001001001001001111111001111001001001111111001001111111001
1000001001000000001000001000001000000000001000000001001001000001000000000001001001000001001001001000000000000001000000001000000000001000001000001001001
1111001111001111001111110000000000001111001001110001001001001001001111111001111001111111001111111111001111111111111001111001111001111111001111111001111
1000001000001000001000000000001001000001001000001000000000001000000001000001000001000000000001000001001001000000000001001001000000000000000001001000001
1111001001111111111001111001111001001100111001111001111111001111111111111001111001111001001111111001001001001111001111001001111001001111111001001001000
1000001000001000000000001001001001000000001000001001000001000001000000000000000001000001000000000000001000001001000001001000001001001000000000000001001
0111001001111111111001111001001001001111111001111111001001111111111001001111001111111111111001001111111001111001111001001111111001111111111111001001111
1000001000001000001001000001000000000000000001001001001000000001000001001001000001000000000001000001000001000001000001000000000001001001000000001000001
1001111001111111001001001001111001111001111001001001111001111001111001001001111001001111111001111001111111111001001111001111111111001001111111001001001
1000001001000001000001001000000001001001000001000000000001000001000001000001001001000001001000001001000000000000000001000000000000000001000000001001001
1001111001111001001001001111001111001111001111111111001111111111111001111001001111011001001001111001111001001111111111001111111001111111111001111111001
1000001000000000001001001000000000001000001000001000000001001000000000001000000001000001000001000000001001001000001000001000000001000000000000001001001
1001001001111001111000011111001111001111001001111001111111001001111111111001111111111111001001111111001001001111001001111001111001001001111001111001111
1001000000001001000001000000000001001001001000000000001001000001001001001000001001000000001000001000001001001000001001001001001001001001000000001001001
1001110011001001111001001111111111111001001111111001111001111001001001001001111001111001001001111111001101111001111111001111001111001111001111111001001
1000001000001000000001000001000001001000001001000000000000000000001000000001001000000001001001000000000001000000000000000001000001001000001000001001001
1001111111001111111001110111001001001001111001001111001111001111111001111001001001111001001111001001111111111001001001111111001001111001001001001001001
1000001000000001000000000001001000000000001000001000001000001000000000001001000001000001001000001001000000000001001000000000001000000001000001000000001
1111111111111111111111011111111111111111111111011111111111111101111111111111101111111111111111111111111101111111110111111111111111111111111111111111001