111111111110000111111111111111100000000001111111111111111111111111111111111000000011111111111111111
111110000000000000001111111111111111110000000000000000000000000000000000111111100000000000000000001
000000000001111000000000000000000000000000011111111110000000000000000000000111111111111111100000011
111000000000000000001111111111111111000000000000000000000000000000000000000000000011111111111000011
111111000000011111111111111111110000000000111111111000000000001111111000000000001111110000000001111
111000000000001111111100000000000000000000000111111111111111111111111111111111110000000000000000001
111111111000000000000000000001111111111111111111111111111111000000000000000000000000000000000111111
111111111000001111111111000001111111111000000011111100000000000000001111111110000000000000000000011
011111110000001111111111000000011111101111101111111111110000000000011111111111111111000000111111111
000011111111100000000000001111111111100111101111100111111111111000000000000000000000011111111110000
110000000011111111000000000000000000000000000011110101111111100000000000000001110011111111100000001
111100000000000000000011111111111111110000000011110101111111100000000000000001110011111111110001111
111110000000000000000111111111001111110000000011110000001111111000000000111111110011111111100001111
111110000111111111111111100000001111110001111111111111101111111000000000111110000011110000000111111
111111011111111111111111110111001111111100000000000000000000111000000000111110111111000000011111111
111110000000000000000011110110000011111100110000000000000010110011111111111110111111100000000000111
111111111000000000000011111110001111111100111111111110000000000011111111111110111111111000000001111
111111111111100000000000000000000001111111111111111100000000000000000000000000000000000000000000111
111111111111111111000000011000001111111111111111111111100000000001111111110111111111111111000000000
111111110111111111111000000000000001111111001111111111111000000000000000000001111111111111000111111
000011110111100000000000001111111111100111101111100111111111111000000000000000000000011111110110000
110000000011111111000000001111111111000000000011110101111111100000000000000001111111111111100000001
111100000000000000000011111111111111110000000011110101111111100000000000000001111111111111110001111
111110000000000000000111111111101111110000000011110000001111111000000000111111111111111111100001111
111110011111110100111111110000000001110001111111111111101111111000000000111111111111110000000111111
111110000000000000001111111110001111110000000000000000000000000000000000111111100000000000000000001
000000000001111000000000000000000000000000011111111110001100111111111000000111111101111111100000011
000000000001111000000000000000000000000000011111111110001100000011100000000111110000000111100000011
111111110111111111111000000000000001111111111110000000000000000000000000000001111111000111000111111
000011110111100000000000001111111111100111101111100111111111111000000000000000000000011111110000011
000000000000000000011111111111111100000000000000000011111111100011111110000000001111111111111111011
111110111001111110000000001111111111100000100000000000000111001111111100000000000000000000000011111
111100011001111111110000000000000000000000000000001111111111001111111111111111000000000010110000000
110000000000111111111110000000000000000111110000000000000000000000111111111111000000000000001111111
111111110000011111111111111111111110000000000001111111111111111111111111111111110000000000000000111
111110000000000000000111111111001111110000000011110000001111111000000000111111110011111111100001111
111110000111111111111111100000001111110001111111111111101111111000111100111110000011110000000111111
111111011111111111111111110111001111111100000000000000000000111000000000111110111111000000011111111
111110000000000000000011110110000011111100110000000000000010110011111001111110111111100000000000111
111111110111111111111000000000000001110000001111111111111000000000000000000001110000000111000111111
000011110111100000000000001111111111100111101111100111111111111000000000000000000000011111110110000
110000000011111111000000001111111111000000000011110101111111100000000000000000001111111111100000001
111111111000001111111111000001111111111000000011110000000000000000011111111100000001111111100000011
011111110000001111111111000000011111101111101111111111110000000000011111111111111111000000111111111
111111111111111111111111111111111111111111110111111111111111111111111111111111111111111011111111111