11111111111111111111111111111111011111111111111111111
11111111100000000011111111100000000000000000000011111
00001111111111011111111110000000000000001111110000000
10000000000000000000000000000000001111111111111111111
11111111111000001000001111111111111111111111000000000
11111111111011111111111110000000111111111111000000000
11111111100011111111000000000001111100001111000000000
11111110000000000000000000000000000001111111111110111
00000001111111111111101111111111111111100000000000000
11100000000000000000001111111111111111111111111111111
11111100000011111111111000001111110111111111111111111
11111111100000000011111111100000000000000000000011111
11100000000000111111111110000000000111111111000000111
00001111111111111111111110000000000000001111110000000
10000000000000000000000000000000001111111111111111111
11111111111000001111111100000011100111111111000000000
11111111111011111111000000000000100000011111000000000
11111111100011111111111111111111111100001111000000000
11111110000000000000000000000000000001111111111110111
00001111111101000000101111111111111111100000000000000
11100000000000000000001111111111111111111111111111111
11111111111110111111111111111111111111111111111111111
11111111111000000000000000000000011111111111111111111
00000111111111111111111111111110111111111111111111111
10000000000000000000000000000000000000000000000000000
11111111110000000000000000000000000000001111111110000
11111111111111000000001111011111101110101111111111111
11100000000000000111111110000000000000010111111111111
11110000000000000000000000000000000000000000000000000
11111111110000000000000000000000000000000000011111111
00000000000000111111111111111111110111110000000000000
11111111111111111111100000000011110111111111000011111
11111111111111111111101111110011110000111111111111111
11111111111111111111111111111000000100000000011111111
00000000000000000000000111111110111111111111111111111